##########
#S#......#
#.#.##.#.#
#K..#..#K#
#...#T##.#
####T#E#.#
#........#
##########