##########
#S.......#
####.###.#
#K.#.#.#.#
#.##.#.#.#
#....T...#
######E###