########
#S.....#
#..##..#
#..#K..#
#......#
####T###
####E###
########